tough - adj - khó khăn
exploit - v - khai thác
due to - - do
equity markets - n - thị trường chứng khoán
volatility - n - biến động
investing - v - đầu tư
towards - v - hướng tới
portfolio - n - danh mục đầu tư
influences - v - ảnh hưởng
manipulate - v - vận dụng
hedge funds - n - quỹ đầu cơ
dividend - n - cổ tức
intend - v - dự định
simultaneous - adv - đồng thời
eliminate - v - loại bỏ
remain + adj - vẫn còn, vãn còn gì đó. to remain silent ( vẫn còn im lặng)
retain - v - giữ lại một cái gì đó, vẫn có một cái gì đó
essentially  adv - bản chất, về cơ bản
period - - giai đoạn
whole - adj - toàn vẹn, hoàn toàn.
significant - adj - có ý nghĩa, đáng kể
underlying - - cơ bản
opportunity - n - ( dịp tốt) thời điểm khi mà tình huống cụ thể giúp bạn cso thể đạt được điều gì đó
recent - - gần đây
volatile - adj - dễ dàng thay đổi 
discard - v - loại 
reveal - v - tiết lộ, làm điều gì đó cho ai đó biết
cumulative - v - tích lũy
bonds - n - trái phiếu
mortgages - n - thế chấp
quantitative - n - định lượng
regard to - liên quan đến
incentive - khích lệ
probably - có lẽ, có khả năng
accordingly - phù hợp
Incentives - v - khuyến khích
primarily - adv - chủ yếu
manner - cách thức
paid - được trả
institutional - n - tổ chức
potential - tiềm năng
broker - n - người môi giới
potentially  - adv - có tiềm năng
corresponding - tương ứng
consequence - kết quả
scenario - n - kịch bản
intrinsic - adj - một đặc điểm cơ bản và cực kỳ quan trọng của 1 ng, 1 vật (nội tại)
accumulate - v - tích lũy, tích trữ
outstanding- adj - lưu hành
interest rate - n - lãi suất
attract - thu hút
versus - so với, đấu với
implication - n - ngụ ý, hàm ý
arbitrage - chênh lệch, chênh lệch giá 
appropriate - adj - thích hợp
dealing - xử lý
aggregated - v - tổng hợp
variation - n - biến thể 
